border_size=1
usage=map

Ds          , Ds          , Ds          , Ds          , Ds          , Ds          , Ds          , Ds          , Ds          , Ds          , Ds          , Ds          , Ds          , Ds          , Ds          , Ds          , Hd          , Hd          , Md          , Md          , Md^Xm       , Md^Xm       
Ds          , Ds          , Ds          , Ds          , Ds          , Ds          , Ds          , Ds          , Ds          , Ds          , Ds          , Ds          , Ds          , Ds          , Ds          , Ds          , Dd          , Md          , Md          , Md^Xm       , 2 Md^Xm     , Md^Xm       
Ds          , Ds          , Ds          , Ds          , Dd^Do       , Dd          , Dd          , Ds          , Ds          , Ds          , Ds          , Ds          , Kh          , Ds          , Ds          , Ds          , Ds          , Hd          , Md          , Md^Xm       , Md^Xm       , Md^Xm       
Ds          , Ds          , Dd          , Ds          , Ds          , Ds          , Ds          , Ds          , Dd          , Dd          , Ch          , Ch          , Dd^Vda      , Ch          , Ch          , Dd          , Ds          , Hd          , Hd          , Hd          , Hd          , Md          
Ds          , Ds          , Ds          , Dd          , Ds          , Ds          , Dd          , Dd          , Ch          , Ch          , Dd          , Dd^Vda      , Dd^Vda      , Dd^Vda      , Rd          , Ch          , Ch          , Dd          , Dd          , Ds          , Ds          , Ds          
Ds          , Ds          , Ds          , Ds          , Ds          , Ds          , Kh          , Ch          , Ds          , Dd          , Uu          , Xu          , Xu          , Dd          , Rd          , Ds          , Ch          , Ch          , Ch          , Ds          , Ds          , Ds          
Ds          , Ds          , Dd          , Dd          , Dd          , Dd          , Ch          , Dd          , Ds          , Uu          , Ds          , Dd          , Ds          , Xu          , Xu          , Rd          , Ch          , 1 Kh        , Ch          , Dd          , Ds          , Ds          
Ds          , Ds          , Dd          , Dd          , Ds          , Ds          , Ch          , Ds          , Uu          , Uu          , Ds          , Ds          , Md          , Ds          , Ds          , Dd          , Dd          , Ch          , Ch          , Ds          , Ds          , Ds          
Ds          , Ds          , Ds          , Ds          , Ds          , Ds          , Ch          , Ds          , Uu          , Ds          , Uu          , Md          , Md          , Md          , Uu          , Dd          , Rd          , Ds          , Ch          , Ds          , Ds          , Ds          
Ds          , Ds          , Ds          , Ds          , Dd          , Ds          , Ch          , Dd          , Ds          , Ds          , Uu          , Md          , Md          , Md          , Uu          , Ds          , Uu          , Ds          , Ch          , Ds          , Dd          , Ds          
Ds          , Ds          , Ds          , Ds          , Dd          , Ds          , Ch          , Ch          , Ch          , Dd          , Rd          , Uu          , Uu          , Uu          , Rd          , Rd          , Uu          , Ds          , Ch          , Ds          , Ds          , Ds          
Ds          , Ds          , Ds          , Ds          , Dd          , Ds          , Ch          , Kh          , Ch          , Rd          , Uu          , Ds          , Rd          , Ds          , Uu          , Uu          , Dd          , Ds          , Kh          , Dd          , Ds          , Ds          
Ds          , Ds          , Ds          , Ds          , Dd          , Ds          , Ds          , Ch          , Ch          , Rd          , Rd          , Uu          , Uu          , Uu          , Ds          , Dd          , Ch          , Ch          , Dd          , Ds          , Ds          , Ds          
Dd          , Ds          , Ds          , Ds          , Ds          , Ds          , Dd          , Dd          , Ds          , Kh          , Rd          , Rd          , Ds          , Ds          , Ch          , Ch          , Ds          , Ds          , Ds          , Dd          , Ds          , Ds          
Ds          , Dd          , Dd          , Dd          , Dd          , Ds          , Ds          , Ds          , Rd          , Rd          , Rd          , Rd          , Kh          , Ch          , Dd          , Ds          , Ds          , Ds          , Ds          , Ds          , Ds          , Ds          
Ds          , Ds          , Ds          , Ds          , Ds          , Ds          , Rd          , Rd          , Rd          , Rd          , Dd          , Ds          , Ds          , Ds          , Ds          , Ds          , Ds          , Dd          , Dd          , Ds          , Ds          , Ds          
Ds          , Ds          , Ds          , Dd^Do       , Rd          , Rd          , Rd          , Rd          , Dd          , Dd          , Ds          , Dd          , Ds          , Ds          , Ds          , Ds          , Ds          , Ds          , Ds          , Ds          , Hd          , Hd          
Ds          , Ds          , Rd          , Rd          , Rd          , Rd          , Dd          , Ds          , Ds          , Ds          , Ds          , Ds          , Ds          , Ds          , Ds          , Ds          , Ds          , Ds          , Hd          , Hd          , Hd          , Ds          
Rd          , Rd          , Rd          , Rd          , Ds          , Ds          , Ds          , Dd          , Ds          , Ds          , Dd          , Ds          , Ds          , Ds          , Dd          , Ds          , Hd          , Hd          , Hd          , Hd          , Md          , Md          
Rd          , Rd          , Ds          , Ds          , Ds          , Ds          , Dd          , Dd^Do       , Ds          , Ds          , Ds          , Ds          , Ds          , Ds          , Ds          , Ds          , Hd          , Hd          , Hd          , Md          , Md          , Md^Xm       
Ds          , Ds          , Ds          , Ds          , Ds          , Ds          , Ds          , Dd          , Ds          , Ds          , Ds          , Ds          , Ds          , Ds          , Ds          , Ds          , Hd          , Hd          , Md          , Md          , Hh^Vhh      , Md^Xm       
Ds          , Ds          , Ds          , Ds          , Ds          , Ds          , Ds          , Ds          , Ds          , Ds          , Ds          , Ds          , Ds          , Ds          , Ds          , Hd          , Hd          , Hd          , Md^Xm       , Md^Xm       , Md^Xm       , Md^Xm       
