border_size=1
usage=map

Md^Xm       , Md          , Md^Xm       , Md          , Md          , Md          , Md          , Md          , Md          , Md          , Md          , Md          , Md^Xm       , Md^Xm       , Md^Xm       , Md^Xm       , Md^Xm       , Md^Xm       , Md^Xm       , Md^Xm       , Md^Xm       , Md^Xm       
Md^Xm       , 3 Md^Xm     , Md^Xm       , Md^Xm       , Kv          , Md          , Rr          , Rr          , Rr          , Rr          , Rd          , Rd          , Rd          , Md          , Md          , Md^Xm       , Md          , Md          , Md          , Md^Xm       , Md          , Md^Xm       
Md^Xm       , Md^Xm       , 2 Kv        , Kv          , Kv          , Rr          , Md          , Md          , Md^Xm       , Md^Xm       , Md^Xm       , Md^Xm       , Md          , Rd          , Rd          , Md          , Md          , Md          , Md          , Md          , Md          , Md          
Md          , Md^Xm       , Md^Xm       , Kv          , Md^Xm       , Md^Xm       , Md^Xm       , Md^Xm       , Md          , Md          , Hd          , Md          , Md          , Hd          , Rd          , Md          , Hd          , Md          , Hd          , Md          , Hd          , Md          
Md          , Md          , Md          , Md^Xm       , Md          , Md          , Md          , Md          , Md          , Md          , Hd          , Hd          , Hd          , Hd          , Hd          , Hd          , Hd          , Hd          , Hd          , Hd          , Hd          , Ds          
Hd          , Md          , Md          , Md          , Md          , Md          , Hd          , Md          , Hd          , Hd          , Hd          , Hd          , Dd          , Hd          , Rd          , Hd          , Hd          , Hd          , Dd          , Hd          , Dd          , Dd          
Hd          , Hd          , Hd          , Hd          , Hd          , Hd          , Hd          , Hd          , Hd          , Hd          , Hd          , Hd          , Dd          , Dd          , Rd          , Dd          , Dd          , Dd          , Dd^Do       , Dd^Do       , Dd^Do       , Dd          
Hd          , Hd          , Hd          , Hd          , Hd          , Hd          , Hd          , Hd          , Hd          , Hd          , Dd          , Dd          , Dd          , Dd          , Dd          , Dd          , Dd          , Dd          , Dd^Do       , Gs          , Dd^Do       , Dd          
Dd          , Hd          , Hd          , Hd          , Dd^Do       , Hd          , Dd          , Hd          , Dd          , Dd          , Dd          , Dd          , Dd          , Rd          , Dd          , Dd          , Dd          , Dd          , Dd          , Dd^Do       , Dd          , Dd          
Dd          , Dd          , Dd          , Dd          , Dd          , Dd          , Dd          , Dd          , Dd          , Dd          , Dd          , Dd          , Dd          , Rd          , Dd          , Dd          , Dd          , Dd          , Dd          , Dd          , Dd          , Dd          
Ds          , Dd          , Ds          , Dd          , Ds          , Dd          , Ds          , Dd          , Dd          , Dd          , Dd          , Dd          , Dd          , Dd          , Ds          , Dd          , Ds          , Dd          , Dd          , Dd          , Dd          , Dd          
Rd          , Dd^Dc       , Ds          , Ds          , Ds          , Ds          , Dd^Dc       , Ds          , Ds          , Ds          , Rd          , Ds          , Rd          , Ds          , Ds          , Ds          , Ds          , Dd^Dc       , Ds          , Ds          , Rd          , Rd          
Ds          , Ds          , Rd          , Ds          , Ds          , Ds          , Ds          , Ds          , Ds          , Rd          , Ds          , Dd^Dc       , Ds          , Rd          , Dd^Do       , Ds          , Rd          , Rd          , Rd          , Ds          , Ds          , Ds          
Ds          , Ds          , Ds          , Rd          , Dd^Do       , Ds          , Rd          , Rd          , Ds          , Ds          , Ds          , Ds          , Ds          , Ds          , Ds          , Ds          , Ds          , Ds          , Ds          , Ds          , Ds          , Ds          
Ds          , Ds          , Ds          , Ds          , Ds          , Ds          , Ds          , Ds          , Ds          , Ds          , Ds          , Ds          , Ds          , Ds          , Ds          , Ds          , Ds          , Ds          , Ds          , Dd^Dc       , Ds          , Ds          
Ds          , Ds          , Ds          , Ds          , Dd^Dc       , Rd          , Ds          , Ds          , Ds          , Ds          , Ds          , Ds          , Ds          , Ds          , Ds          , Ds          , Ds          , Ds          , Ds          , Ds          , Ds          , Ds          
Ds          , Ds          , Ds          , Ds          , Ds          , Rd          , Ds          , Ds          , Ds          , Ds          , Ds          , Ds          , Ds          , Dd^Dc       , Ds          , Ds          , Ds          , Ds          , Rd          , Ds          , Ds          , Ds          
Ds          , Ce          , Ce          , Ds          , Ds          , Ds          , Ds          , Ds          , Ds          , Ds          , Ds          , Ds          , Ds          , Ds          , Ds          , Ds          , Rd          , Rd          , Ds          , Dd^Dr       , Rd          , Ds          
Uh          , Ce          , 1 Ke        , Ce          , Rd          , Rd          , Ds          , Ds          , Ds          , Dd^Dc       , Rd          , Ds          , Ds          , Ds          , Rd          , Ds          , Ds          , Dd^Do       , Ds          , Ds          , Ds          , Ds          
Xu          , Uh          , Uh          , Ds          , Ds          , Ds          , Rd          , Rd          , Ds          , Rd          , Ds          , Rd          , Ds          , Rd          , Ds          , Ds          , Ds          , Ds          , Ds          , Ds          , Ds          , Ds          
Xu          , Xu          , Rd          , Rd          , Uh          , Ds          , Ds          , Ds          , Ds          , Ds          , Ds          , Ds          , Dd^Dc       , Ds          , Ds          , Ds          , Ds          , Ds          , Ds          , Ds          , Ds          , Ds          
Rr          , Rp          , Xu          , Xu          , Xu          , Uh          , Uh          , Ds          , Ds          , Ds          , Ds          , Ds          , Ds          , Ds          , Ds          , Ds          , Ds          , Ds          , Ds          , Ds          , Ds          , Ds          
