border_size=1
usage=map

Md^Xm       , Md          , Md^Xm       , Md          , Md          , Md          , Md          , Md          , Md          , Md          , Md          , Md          , Md^Xm       , Md^Xm       , Md^Xm       , Md^Xm       , Md^Xm       , Md^Xm       , Md^Xm       , Md^Xm       , Md^Xm       , Md^Xm       
Md^Xm       , Md^Xm       , Md^Xm       , Md^Xm       , Kv          , Md          , Rr          , Rr          , Rr          , Rr          , Rd          , Rd          , Rd          , Md          , Md          , Md^Xm       , Md          , Md          , Md          , Md^Xm       , Md          , Md^Xm       
Md^Xm       , Md^Xm       , 3 Kv        , Kv          , Kv          , Rr          , Md          , Md          , Md^Xm       , Md^Xm       , Md^Xm       , Md^Xm       , Md          , Rd          , Rd          , Md          , Md          , Md          , Md          , Md          , Md          , Md          
Md          , Md^Xm       , Md^Xm       , Kv          , Md^Xm       , Md^Xm       , Md^Xm       , Md^Xm       , Md          , Md          , Hd          , Md          , Md          , Hd          , Hd          , Md          , Hd          , Md          , Hd          , Md          , Hd          , Md          
Md          , Md          , Md          , Md^Xm       , Md          , Md          , Md          , Md          , Md          , Md          , Hd          , Hd          , Hd          , Hd          , Rd          , Hd          , Hd          , Hd          , Hd          , Hd          , Hd          , Ds          
Hd          , Md          , Md          , Md          , Md          , Md          , Hd          , Md          , Hd          , Hd          , Hd          , Hd          , Dd          , Hd          , Hd          , Hd          , Hd          , Hd          , Dd          , Hd          , Dd          , Dd          
Hd          , Hd          , Hd          , Hd          , Hd          , Hd          , Hd          , Hd          , Hd          , Hd          , Hd          , Hd          , Dd          , Dd          , Rd          , Dd          , Dd          , Dd          , Dd^Do       , Dd^Do       , Dd^Do       , Dd          
Hd          , Hd          , Hd          , Hd          , Hd          , Hd          , Hd          , Hd          , Hd          , Hd          , Dd          , Dd          , Dd          , Dd          , Dd          , Dd          , Dd          , Dd          , Dd^Do       , Dd          , Dd^Do       , Dd          
Dd          , Hd          , Hd          , Hd          , Dd^Do       , Hd          , Dd          , Hd          , Dd          , Dd          , Dd          , Dd          , Dd          , Rd          , Dd          , Dd          , Dd          , Dd          , Dd          , Dd^Do       , Dd          , Dd          
Dd          , Dd          , Dd          , Dd          , Dd          , Dd          , Dd          , Dd          , Dd          , Dd          , Dd          , Dd          , Dd          , Rd          , Dd          , Dd          , Dd          , Dd          , Dd          , Dd          , Dd          , Dd          
Ds          , Dd          , Ds          , Dd          , Ds          , Dd          , Ds          , Dd          , Dd          , Dd          , Dd          , Dd          , Dd          , Dd          , Ds          , Dd          , Ds          , Dd          , Dd          , Dd          , Dd          , Dd          
Ds          , Dd^Dc       , Ds          , Ds          , Ds          , Ds          , Dd^Dc       , Ds          , Ds          , Ds          , Ds          , Ds          , Rd          , Rd          , Rd          , Rd          , Ds          , Dd^Dc       , Ds          , Ds          , Ds          , Ds          
Ds          , Ds          , Ds          , Ds          , Ds          , Ds          , Ds          , Ds          , Ds          , Ds          , Rd          , Dd^Dc       , Ds          , Ds          , Dd^Do       , Ds          , Ds          , Rd          , Rd          , Rd          , Rd          , Ds          
Ds          , Ds          , Ds          , Ds          , Dd^Do       , Ds          , Ds          , Ds          , Ds          , Ds          , Ds          , Ds          , Ds          , Ds          , Ds          , Ds          , Ds          , Ds          , Ds          , Ds          , Ds          , Ds          
Rd          , Rd          , Ds          , Rd          , Rd          , Ds          , Ds          , Ds          , Ds          , Rd          , Ds          , Ds          , Ds          , Ds          , Ds          , Ds          , Ds          , Ds          , Ds          , Dd^Dc       , Ds          , Ds          
Ds          , Ds          , Ds          , Ds          , Dd^Dc       , Ds          , Rd          , Ds          , Ds          , Rd          , Ds          , Ds          , Ds          , Ds          , Ds          , Ds          , Ds          , Ds          , Ds          , Ds          , Ds          , Ds          
Ds          , Ds          , Ds          , Ds          , Ds          , Ds          , Ds          , Rd          , Ds          , Rd          , Ds          , Ds          , Ds          , Dd^Dc       , Ds          , Ds          , Ds          , Ds          , Ds          , Ds          , Ds          , Ds          
Ds          , Ce          , Ce          , Ds          , Ds          , Ds          , Ds          , Ds          , Rd          , Ds          , Ds          , Rd          , Rd          , Ds          , Ds          , Ds          , Ds          , Ds          , Ds          , Dd^Dr       , Ds          , Ds          
Uh          , Ce          , 2 Ke        , Ce          , Ds          , Ds          , Ds          , Rd          , Ds          , Dd^Dc       , Ds          , Ds          , Ds          , Ds          , Rd          , Ds          , Ds          , Dd^Do       , Ds          , Ds          , Ds          , Ds          
Xu          , Uh          , Uh          , 1 Ds        , Rd          , Rd          , Ds          , Ds          , Ds          , Ds          , Ds          , Ds          , Ds          , Ds          , Ds          , Rd          , Rd          , Ds          , Rd          , Rd          , Rd          , Ds          
Xu          , Xu          , Rd          , Rd          , Uh          , Ds          , Ds          , Ds          , Ds          , Ds          , Ds          , Ds          , Dd^Dc       , Ds          , Ds          , Ds          , Ds          , Ds          , Ds          , Ds          , Ds          , Ds          
Rr          , Rp          , Xu          , Xu          , Xu          , Uh          , Uh          , Ds          , Ds          , Ds          , Ds          , Ds          , Ds          , Ds          , Ds          , Ds          , Ds          , Ds          , Ds          , Ds          , Ds          , Ds          
