|0000011111111111111111
|0000001111111111111111
|0000001111111111111111
|0000001111111111111111
|0000001111111111111111
|0000001111111111111111
|0000011111111111111111
|0000001111111111111111
|0000011111111111111111
|0000011111111111111111
|0000011111111111111111
|0000001111111111111111
|0000011111111111111111
|0000011111111111111111
|0000011111111111111111
|0000001111111111111111
|0000001111111111111111
|0000000000000000000000
|0000000000000000000000
|0000000000000000000000
|0000000000000000000000
|0000000000000000000000