|11111111111111111111111111111111
|11111111111111111111111111111111
|11111111111111111111111111111111
|11111111111111111111111111111111
|11111111111111111111111111111111
|11111111111111111111111111111111
|11111111111111111111111111111111
|11111111111111111111111111111111
|11111111111111111111111111111111
|11111111111111111111111111111111
|11111111110000111111111111111111
|11111111110000011111111111111111
|11111111100000011111111111111111
|11111111100000001111111111111111
|11111111000000001111111111111111
|11111111100000000111111111111111
|11111111100000001111111111111111
|11111111110000000111111111111111
|11111111110000000111111111111111
|11111111111111110111111111111111
|11111111111111111111111111111111
|11111111111111111111111111111111
|11111111111111111111111111111111
|11111111111111111111111111111111
|11111111111111111111111111111111
|11111111111111111111111111111111
|11111111111111111111111111111111
|11111111111111111111111111111111
|11111111111111111111111111111111
|11111111111111111111111111111111
|11111111111111111111111111111111
|11111111111111111111111111111111